 7  7  7  7  7  7  7  7  7  7  7  7  7  7  7  7  7  7  7  7  7  7  7  7  7
 9  9  9  9  9  9  9  9  9  8  9  9  9  8  9  9  9  9  9  0  0  0  9  9  9
 2  2  2  2  2  2 10  2  2  2 10  2  2  2 10  9  9  9  9  2  2  2  9  9  9
 9  9  9  9  9  9 10  9  9  9 10  9  9  9 10  9  9  9  9  9  9  9  9  9  9
 0  3  0  9  9  9 10  4  5  4 10  5  4  5 10  4  5  4  5  4  5  4  5  4  5
 2  2  2  2  2  2 10  2  2  2  2  2  2  2 10  2  2 10  2  2  2  2 10  2  2
 9  9  9  9  9  9 10  9  9  9  9  9  9  9 10  9  9 10  9  9  9  9 10  9  9
 9  9  9  9  9  9 10  9  9  9  9  9  9  9 10  9  9 10  9  9  9  9 10  9  9
 9  9  9  9  9  9 10  9  9  9  9  9  9  9 10  9  9 10  4  5  4  5 10  9  9
 1 10  2  2  2  2 10  2  2  2  2  2  2  2 10  2  2  2  2  2  2  2  2  2  2
 1 10  9  9  9  9 10  9  9  9  9  9  9  9 10  9  9  9  9  9  9  9  9  9  9
 1 10  0  0  0  0 10  0  0  0  8  3  8  0 10  0  0  8  8  8  3  8  8  0  0
 1  1  1  1  1  1  1  1  1  1  1  1  1  1  1  1  1  1  1  1  1  1  1  1  1