 9  9  9  9  9  9  9  9  9  9  9  9  9  9  9  9  9  9  9  9  9  9  9  9  9
 9  9  9  9  9  9  9  9  9  9  9  9  9  9  9  9  9  9  9  9  9  9  9  9  9
 5  6  1  1  5 10  6  1  1  1  5 10  6  1  1  1  5 10  6  1  1  1  1  1  1
 9  9  9  9  9 10  9  9 13  9  9 10  9  9  9  9  9 10  9  9  9  9  9  9  9
 9  9  9  9  9 10  9  9  9  9  9 10  9  9  9  9  9 10  9  9  9  9  9  9  9
 9  9  9  9  9 10  9  9  9  9  9 10  9  9  9  9  9 10  9  9  9  9  9  9  9
 5  6  1  1  5 10  1  1  5  6  1  1  1  5  6  1  1 10  6  1  1  1  1  1  1
 9  9  9  9  9 10  9  9  9  9  9  9  9  9  9  9  9 10  9  9  9  9  9  9  9
 9  9  9  9  9 10  9  9  9  9  9  9  9  9  9  9  9 10  9  9  9  9  9  9  9
 2  2  2  2  2  2  2  3 10  9  9  9  9  9  9 10  4  2  2  2  2  2  2  2  2
 0  0  0  0  0  0  0  9  6  1  1  1  1  1  1  5  9  0  0  0  0  0  0  0  0
 9  9  9  9  9  9  9  9  9  9  9  9  9  9  9  9  9  9  9  9  9  9  9  9  9
 9  9  9  9  9  9  9  9  9  9  9  9  9  9  9  9  9  9  9  9  9  9  9  9  9