 9  9  9  9  9  9  9  9  9  9  9  9  9  9  9  9  9  9  9  9  9  9  9  9  9
 9  9  9  9  9  9  9  9  9  9  9  9  9  9  9  9  9  9  9  9  9  9  9  9  9
 0  0  0  0  0  0  0  0  0  0  0  0  0  0  0  0  0  0  0 10  0  0  0 10  0
 9  9  9  9  9  9  9  9  9  9  9  9  9  9  9  9  9  9  9 10  9  9  9 10  9
 9  9  9  9  9  9  9  9  9  9  9  9  9  9  9  9  9  9  9 10  9  9  9 10  9
 9  9  9  9  9  9  9  9  9  9  9  9  9  9  9  9  9  9  9 10  9  9  9 10  9
 9  9  9  9  9  9  9  9  9  9  9  9  9  9  9  9  9  9  9 10  9  9  9 10  9
 9  9  9  9  9  9  9  9  9  9  9  9  9  9  9  9  9  9  9 10  9  9  9 10  9
 3  4  8  3  4  8  3  4  8  3  4  9  9  9  9  9  9  8  8 10  8  8  9 10  9
 0  0  0  0  0  0  0  0  0  0  0  5  6  5  6  5  6  0  0  0  0  0  0  0  0
 7  7  7  7  7  7  7  7  7  7  7  1  1  1  1  1  1  7  7  7  7  7  7  7  7
 7  7  7  7  7  7  7  7  7  7  7  2  2  2  2  2  2  7  7  7  7  7  7  7  7
 7  7  7  7  7  7  7  7  7  7  7  2  2  2  2  2  2  7  7  7  7  7  7  7  7