 9  9  9  9  9  9  9  9  9  9  9  9  9  9  9  9  9  9  9  9  9  9  9  9  9
 9  9  9  9  9 16  9  9  9  9  9 16  9  9  9  9  9 16  9  9  9  9  9 13  9
 9  9  9  9  9 12  9  9  9  9  9 12  9  9  9  9  9 12  9  9  9  9  9  9  9
 9  9  9  9  9 12  9  9  9  9  9 12  9  9  9  9  9 12  9  9  9  9  9  9  9
 9  9  9  9  9 12  9  9  9  9  9 12  9  9  9  9  9 12  9  9  9  9  9  9  9
 9  9  9  9  9 16  9  9  9  9  9 16  9  9  9  9  9 16  9  9  9  9  9  9  9
 9  9  9  9  9 12  9  9  9  9  9  9  9  9  9  9  9 12  9  9  9  9  9  9  9
 9  9  9  9  9 12  9  9  9  9  9  9  9  9  9  9  9 12  9  9  9  9  9  9  9
 9  9  9  9  9 16  9  9  9  9  9  9  9  9  9  9  9 16  9  9  9  9  9  9  9
 9  9  9  9  9  9  9  9 16  9  9  9  9  9  9 16  9  9  9  9  9  9  9  9  9
 7  7  7  7  7  7  7  7 12  9  9  9  9  9  9 12  7  7  7  7  7  7  7  7  7
 8  8  8  8  8  8  8  8  7  7  7  7  7  7  7  7  8  8  8  8  8  8  8  8  8
 8  8  8  8  8  8  8  8  8  8  8  8  8  8  8  8  8  8  8  8  8  8  8  8  8