 9  9  9  9  9  9  9  9  9  9  9  9  9  9  9  9  9  9  9  9  9  9  9  9  9 
 9  9  9  9  9  9 16  9  9  9 16  9  9  9 16  9  9  9  9  9  9  9  9  9  9
 9  9  9  9  9  9 12  9  9  9 12  9  9  9 12  9  9  9  9  9  9  9  9  9  9
 9  9  9  9  9  9 12  9  9  9 12  9  9  9 12  9  9 16  9  9  9  9 16  9  9
 9  9  9  9  9  9 16  9  9  9 16  9  9  9 16  9  9 12  9  9  9  9 12  9  9
 9  9  9  9  9  9 12  9  9  9  9  9  9  9 12  9  9 12  9  9  9  9 12  9  9
 9  9  9  9  9  9 12  9  9  9  9  9  9  9 12  9  9 12  9  9  9  9 12  9  9
 9  9  9  9  9  9 12  9  9  9  9  9  9  9 12  9  9 16  9  9  9  9 16  9  9
 9  9  9  9  9  9 16  9  9  9  9  9  9  9 16  9  9  9  9  9  9  9  9  9  9
 9 16  9  9  9  9 12  9  9  9  9  9  9  9 12  9  9  9  9  9  9  9  9  9  9
 9 12  9  9  9  9 12  9  9  9  9  9  9  9 12  9  9  9  9  9  9  9  9  9  9
 9 16  9  9  9  9 16  9  9  9  9  9  9  9 16  9  9  9  9  9  9  9  9  9  9
 9  9  9  9  9  9  9  9  9  9  9  9  9  9  9  9  9  9  9  9  9  9  9  9  9 